1111111
1000001
1000001111111111111111111111111111111
1000001                             1
1000003111111111111111111111111111111
1000001111111111111111111111111111111
1000002000000020000000000020000000003
1000001111111111111111111111111111111
1000001111111111111111111111111111111
1000001                             1
1000001111111111111111111111111111111
1000001
1000001
1000001
1000001
1000001
1000001
1112111
1110111
1110111
1112111
1110111
1110111
1111111