NO ./textures/wall_north.png
SO ./textures/wall_south.png
WE ./textures/wall_west.png
EA ./textures/wall_east.png
F 220,100,0
C 225,30,0
11111   1111111111111111111111111
10N01   1000000000110000000000001
11111   1011000001110000000000001
       1001000000000000000000001
111111111011000001110000000000001
1000000011000001110111111111111
11110111111111011100000010001
11110111111111011101010010001
11000000110101011100000010001
10000000000000001100000010001
10000000000000001101010010001
110000011101010111110111100111
11110111 1110101 101111010001 
11111111 1111111 1111111111101
11111111 1111111 1111111111111

