NO ./textures/wall_north.png
SO ./textures/wall_south.png
WE ./textures/wall_west.png
EA ./textures/wall_east.png

F 220,100,0
C 225,30,0

1111111
1000001
1000001111111111111111111111111111111
100001                             1
1000001111111111111111111111111111111
1000001111111111111111111111111111111
1000001000000010000000000010000000001
10W0001111111111111111111111111111111
1000001111111111111111111111111111111
1000001                             1
1000001111111111111111111111111111111
1000001
1000001
1000001
1000001
1000001
1000001
1111111
1110111
1110111
1111111
1110111
1110111
1111111