10001
10001
10001
11011
10001
11011
11011
11011
10001
11111