1111111
1000001
1000001
1000001
1000001
100000111111111
100000200000001
100000111111111
1000001
1000001
1000001
1000001
1000001
1000001
1000001
1000001
1000001
1111111