1111111
1000001
1000001
1101001
1000001
1101001
1101001
1101001
1000001
1000001
1000001
1000001
1000001
1000001
1000001
1000001
1000001
1111111