1111111
1000001
1000001111111111111111111111111111111
1000001                             1
1000001111111111111111111111111111111
1000001111111111111111111111111111111
1000002000000020000000000020000000002
1000001111111111111111111111111111111
1000001111111111111111111111111111111
1000001                             1
1000001111111111111111111111111111111
1000001
1000001
1000001
1000001
1000001
1000001
1111111