1111111111111111111111111
1000000000110000000000001
1000000001110000000000001
1000000000000000000000001
1000000001100000111000011
1000000000110000011101111
1111111111111111111111111