NO ./textures/wall_north.png
SO ./textures/wall_south.png
WE ./textures/wall_west.png
EA ./textures/wall_east.png
F 240, 240, 240
C 10, 10, 10

1111111
1000001
10W0001111111111111111111111111111111
1000001                             1
1000001111111111111111111111111111111
1000001111111111111111111111111111111
1000002000000020000000000020000000003
1000001111111111111111111111111111111
1000001111111111111111111111111111111
1000001                             1
1000001111111111111111111111111111111
1000001
1000001
1000001
1000001
1000001
1000001
1111111
1110111
1110111
1111111
1110111
1110111
1111111